########
#      #
# .$   #
# .$@  #
# .$   #
#      #
########
